1111111111111
10P001C000001
1100110010C01
1C00000011111
1111100000001
1000101111001
1C000000C10E1
1111111111111
