111111111111111111
1P001C001C00010C01
110011001110000001
1C0000000000011111
111110000C00010C01
100010111100010001
1C000C00C100C000E1
111111111111111111